1111111111111
10C010C010C01
1C1C1C1C1C1C1
1E10C010C0101
1111111111101
1P0C0C0C0C0C1
1111111111111