11111111111
1P0C100C1C1
11100010001
1E111011101
100C001C001
11111111111