11111111111111111111111111111
1P000000C000C010C000000C00001
11101111101111101110111101111
100010C0000100000C000C000C001
10111010111101110111101110111
10000010000C000010C0000100001
11110111011111110111111110111
1C000C0000000C000000C000000E1
10111111110111011110111111111
100000C000010000000010000C001
11101110111111111110111011111
1C0010C0000C000C0000000C00001
11111111111111111111111111111