111111111111111111111111111111
1P001000C000C010C000000C0000C1
111011111011111011101111011101
100010C0000100000C000C000C0001
101110101111011101111011101111
10000010000C000010C00001000001
111101110111111101111111101111
1C000C0000000C000000C0000000E1
101111111101110111101111111101
100000C000010000000010000C0001
111011101111111111101110111111
1C0010C0000C000C0000000C000001
111111111111111111111111111111