1111111111111111111111111111111111111111
1P100000C000C000C000000C000000000C000001
1010111111111111111111111111111111111101
101C10C0000C00000C000C000C000000C00001C1
1C10101111111111111111111111111111110101
1010101000C000C00C0000C000000C0000010101
1C101010111111111111111111111111110101C1
101C10101000C00000C000000C000000C1010101
1C10101010111111111111111111111101010101
10101010100C000C0000C0000C0000E1010101C1
101C101011111111111111111111111101010101
1C10101010C01000100010001C00100001010101
10101010001000100010001000100010010101C1
1C1C101111111111111111111111111111010101
101010000C000C0000C0000C0000C00C00010101
1C101111111111111111111111111111111101C1
1010000C0000C0000C0000C0000C0000C0000101
1C11111111111111111111111111111111111101
10C0C0C0C0C0C00C0C0C0C0C0C0C0C0C0C0C0C01
1111111111111111111111111111111111111111