1111111111111
1111C1111E111
1111111111111
111P111111111
1111111111111