1111111111111
100100C00C001
1C0Z011111001
1P0011E00C001
1111111111111