111111
1000E1
100C01
10C001
1P0001
111111