11111111111111111111111111111111111111111111111111
1P000000C000C010C000000C000000000C000000000C000011
10111110101111101110111011101111011101111111011111
100000C0000100000C000C000C000000010000000010000001
10111110111101110111101110111011101110111101111111
1010C000010000000C00001000000000100000000010000001
10101011111011111111111110111111011111111011111111
10000000C000000000C0000000000000C00000000000000001
11111110101110111101111111011111110101111111111111
1C0000001000000C000000000C00000000000C0000000000E1
11101111111111111111111111111111111111111111111111
100000000000C000000000010C00000000000C000000000001
10111011111011101111110101111110111110111101111111
100C001C00000010000C0010000C0001000000000000000001
11111110111111101111111111110111011110111011111111
1C000000100000001C0000000000010000000C0000000000C1
10111111101111111111111111011111111111111111111111
1000C0001000000010000C00000100000C0000000000000001
10111010111111011011101111110111011110111111011111
10C0000000000C0000000000C00000000C00000C0000000001
11111111111111111111111111111111111111111111111111
100000000000C0000000000000C00000000000000000000001
10111111101111111111111111101111111011111111111111
1000000C000000000000C000000000000000000C0000000001
11111111111111111111111111111111111111111111111111